#################################################
#                        ooo         #         <=1
#         #               #          ooo        #
#         #      oooooo   #          #  #       #
#        oo   OOOooo  oo  #    #       #        #
<=        #   OOoooooooo       #       #       <=2
#      #  #     ooo  ooo       #                #
#       #oo                  ooo                #
#        ##                oooo#                #
#                             o#               <=3
#################################################